sm Caucaseos
De Busnago.: Sorores tres.
Dc CugooIo in vicomercato: Sorores norem.
De Capitcvici ibi supra: Sorores oiio.
De ia Valle riri supra: Sorores norem.
De Bernadigio: Sorores norem, fraterculum onum.
, De Mesate: Sorores quinque, fratercuium unum. '
De Archori: Sorores septem, samus. . . . . .-
De Gorgonzoia: Sorores sex, samus. . 0 · ω
De inzago: Sorores sex.
De Cossano: Sorores quinque.
ia Insula Folcberiaae ultre Abderam areat :erra namu:
Fratrum, ds aaa Domus Sororum.
De Ripaita: Fratres quinque, Sor.. . . samui .....
De Vaiiato: Fratres tres, Sorores quatuor, samus. . . ..¹
De Triviiio: Fratres sex, Sorores osto, famul ..... ’
De Cairinzano: Fratres quatuor, Sorores tres.
De Carauagio, Fratres undecim, Sorores quatuor.
De Fornovo ibi supra: Fratres osto, Sorores tres,samui.··
De Bregnaoo: Fratres quinque, Sorores tres.
Domus Sororum de Ripaita: Sorores serr, samus. . · ··
In Cumis, Is Diocess erant multe Domus Fratrum.
De Rondeuario: Fratres sexdecim, Sorores duas, samono
unum.
De Vico superiori: Fratres novemdecim, Soror· . usffl
quatuor. ,
De Vico inferiori: Fratres osto, Sororem unam ,samaram
De Zeno: Fratres sex, Sorores undecim, famulos duos. ’ ¹
De Oigiato in Diaerefi: Fratres quatuor, Sor. quiaque· i
De Tremelio: Fratres ser, Soror. duodecim. i
De Adevena: Fratres quinque. i
De S. Gregorio: Fratres sex, Sorores septem. Ν

De Domafio: Fratres quiaque, Sororem unam· De Ι

 

